6 6 
3 3 2 1 h
3 2 2 1 h
3 1 2 1 h
5 1 1 2 v
5 3 1 2 v