6 6 
1 3 2 1 h
3 1 1 3 v 
5 3 1 3 v
3 5 2 1 h
6 2 1 2 v
2 4 1 2 v