6 6 
2 3 2 1 h 
1 1 2 1 h 
1 2 1 3 v 
6 1 1 2 v
4 2 1 3 v
1 6 3 1 h 
6 5 1 2 v 
3 5 3 1 h