6 6 
1 3 2 1 h 
3 1 3 1 h
3 2 1 2 v
6 1 1 3 v
3 5 2 1 h
5 5 2 1 h
